00000000000000000000000000
01111111111111111111111110
01111111111111001111111110
01100111111111111111111110
01111111111111001111111110
01111111111111111111111110
01111111111111111111111110
01111111001111111111111110
01111111111111111111111110
01111111111111111111111110
00000000000000000000000000
